###############################e#############################
#         #     # #   #        E    #         #       #   # #
# ### ### # ### # # # # ######### # # # ####### ### # # # # #
# # #   #   #   # # #   #         # # #           # #   #   #
# # ### ##### ### # ##### ######### ############# # ### #####
#     # #   # # #   #     #       #             # #   # #   #
##### # # ### # # ### ##### ##### ############# ##### ### # #
#     # # #   #   #   #   #   # #           #         #   # #
# ##### # # ### ### ### # ### # ######### ### ####### # ### #
# #   # #   #   #   #   #               #     #   #   # # # #
# # # # ### ##### ### ############# ####### ### # ##### # # #
# # # #   #       #   # #         # #     #   # #     #   # #
# ### ### ######### ### # ####### ### ### ##### ##### ### ###
#   #   # #       #     # #     #   # # #   #   #   # #   # #
### # ### # ##### ####### # ### ### # # ### # ##### # # ### #
# #   #   #     # #       # #     # #   # #   #     # # #   #
# # ### # ### ### # ####### ##### # ### # ##### ### # # # ###
# # #   #   # #   # #     #     # # #   #     #   # #   #   #
# # # ####### # ### ### # ##### # # # ##### # ### # ####### #
#   #         #         #      F# #         #     #         #
###############################f#############################
