#########################################e#######################################
#     #     #   #         #           #  E            # #           #       #   #
# ### # ### # ### # ####### ####### # # # ########### # # ####### ### # ### ### #
# # #   #   # #   #           #     # # # # #         # # # #     #   #   #   # #
# # ##### ### # ############### ##### ### # # ######### # # # ##### ##### ### # #
# #     # #     #     #       #     #     #   #         #   #       #   # # # # #
# ##### # # ##### ### # ##### ##### ######### ######### ### ######### # # # # # #
#     #   #       #   # #   # #   #         #         #   # #     #   # # # # # #
# ### # ############### # ### # # ######### ######### # # # ### # # ##### # # # #
# #   #     #           #     # #         #   #     #   # #   # #   #     # # # #
### # ##### # ########### ##### ######### # # # ##### ####### # ### # ##### # # #
#   # #   # #   #       #       #   #   # # # #       #     # # #   # #     # # #
# # ### # # ### # # ############# # # # # ### ######### ### # # ##### # # ### # #
# # #   # # #   # # #           # # # # #   # #       # # #   #     # # # #   # #
# # # ### # # ##### # ##### ### # # ### ### # # ##### # # ##### ### # ### # ### #
# # #   # # #     #   #   #   # # #       # # # # #   #     # # # # #   # # #   #
# # ### # # ### # ### ### ### # # # ####### # # # # ####### # # # # ### # # # # #
# #   # # #   # #   # #     # #   # #       # # # #         #     #   # #   # # #
# ##### # ### # ### # # ### # ##### # ####### # # ################### # # ##### #
#   #   #   # #   # # #   # # #     # # #     #   #   #             # # # #     #
# # # ##### # ##### # ### # # ####### # # # ##### # # # # ######### # # # # #####
# #   # #   # #     #   # # #   #   # #   # #     # #   #   #     #   # # # #   #
# ##### # ### # ####### # # ### # # # ##### # ####### ##### # ### ### # # # # ###
#   #   #   #   #     #   #   #   #   #     #       # #     # #   # # # #   # # #
### # ##### ##### ########### ######### ### ####### ### ####### # # # # ### # # #
# # #     #   #   #     #   # #       #   #       #   # #       #   # #   # # # #
# # # ### ### # # # ### # # # # ### # # # ####### ### # ### ####### # ### # # # #
# # #   #   # # # # # #   #   # #   # # # #     # # #   #   #       # #   # #   #
# # ####### # # ### # ####### ### ### ### ### ### # ##### ### ####### # ### ### #
# #   #     # #     #   #   #     # #   #   #   # #       #   #       #   #   # #
# ### # ### # ##### # ### # ####### ### ### ### # # ########### ######### # ### #
#   #   #   #     #   #   # #     #   #     #   # # #         # #   # #   # #   #
# # ##### ####### ##### ### # ##### # ####### ### # # ####### # # # # # # ### ###
# #     # #     #     # #   #     # #         #   # #   #   #   # #   # # #   # #
# ##### # ### # ##### # # ####### # ####### # # ### ### # ####### ##### # # ### #
# #   #   #   #   #   # #       #   # #   # #   #     # #         #   # # #   # #
# # ####### ##### # ### ####### # ### # # ##### ### ### ####### ### # # ##### # #
# #         #     # #   #     # #     # #     #     #   #     #   # #   #   # # #
# ##### ##### ##### # ### ### # ####### ##### ####### ### ### ### # ##### # # # #
#       #         #       #   #          F  #             #       #       #     #
#########################################f#######################################
