#####e#####
#    E    #
### ##### #
#   #     #
# #########
#         #
# #########
#     #   #
##### # # #
#    F  # #
#####f#####
