#########################################e#######################################
#           #     #     #       #   #    E    #   #                       #     #
# ### # ##### # ### # # # # ### # # # ####### # # # ##### ############### # ### #
#   # # #     #     # # # #   # # #         #   #   #     # #           # # #   #
# ### # # ########### ### ### ### ##### ####### ##### ##### # ##### ##### ### # #
# #   # #   #   #     #   # #     #   # #     # #     #     #     # #     #   # #
# # ##### ### # # ##### ### ####### # ### ### ### ##### ### ##### # # ##### ### #
# #   #   #   # # #     #   #   #   #   # #     #   #   #       # #   #       # #
# ### # ### ### # # ####### # # # ##### # ##### ### ##### ### ### ######### # # #
# # #   #   #     # #       # # # #   #   #   # #   #   # #   #   #       # # # #
# # ##### # ####### ### ### # # # # ##### # # # # ### # # ##### ##### ### ### ###
# #     # # #   #   #   #   # #   #       # # #   #   # # #   # #     # #   #   #
# ### ### ### # # ### # ##### ##### ####### # ####### # # # # # ### ### ### ### #
#   #   # #   # # #   # #   #   #       #   # #       # #   # #   # #     #     #
### ### # # ### # # ##### # ### ####### # ### # # ##### ##### ### # ##### ##### #
# #     # # # #   #       #   # #   #   # # # # #   # #         # #     #     # #
# ##### # # # ############# ### # # ### # # # ### # # ######### # ##### # # ### #
#     # # #   #           #   #   #   # # # #   # # #     #   # # #   # # #     #
##### # # ### # # ####### ### ####### ### # ### ### # ##### # # # # # # # #######
#     # #     # # #     #     #     #   # # #   #   #       #   #   # # #   #   #
# ##### ####### # # ### ##### ### # ### # # # ### ### ############### # ### # ###
#   #   #   #   # # #   #     #   #   #     # #   # #   #     #     # #   # #   #
# # # ##### # ### ### # # ##### ### ####### # ### # ### # ### # ### # # # # # # #
# #   #   #     #   # # # #     #   #     # # #   #   # # #   # # #   # # # # # #
# ##### # ######### # ### ### ### ### ### ### # ##### # # # ### # ####### # ### #
# #     #   #     # #         #   #   # #   # # #   #     #   #           #   # #
# ##### ### # ### # ### ####### ### ### ### # # # # ######### ############### # #
# #     # #   # # #   # #     #   #   #   #   # # #         #       #         # #
# # ##### ##### # ### ### ### ####### # ####### # ######### ######### ######### #
#   #       #   #   #   #   #   #   # #     #   # #   #   # #         #     #   #
##### ##### # ##### ### ### ### # # # # # # # ### # # # ### # ######### ### # ###
#     #   #   #         #   #     #   # # #   #     # # #   #   #       # # #   #
# ##### ##### # ######### ############### ### # ##### # # ##### # ####### # ### #
#   #         # #   #   #               #   # # #   #   #     #   #       #     #
# # ########### # ### # # ########### # ### ### # # ######### ##### ########### #
# #               #   # # #   #     # #   #     # # #   #   #     #     #     # #
# ################# ### # # ### ### # ### ####### # # # # # ##### # ### # ### # #
#   #       #       # # #   #   # # #   # #       #   # # #     # #   #     #   #
### # # ### # ####### # ### # ### # ##### # ########### # ##### # ### ######### #
#   # # #   # #       #   # # #     #     # # #       #   #   # #     #   #   # #
# ##### # ### # ##### ### ### # ##### # ### # # # ### ####### # # ####### # # ###
# #   # # #   #     #   #   # # #   # # #   #   # # #   #     # # #     # # #   #
# # # # # # ### ### # ##### # # # # # ### ####### # ### # ### # # ### # # # #####
# # #   # #   #   # # #   #   # # # #   #         #   #   # # # #     # # #     #
# # ### ##### ##### ### # ##### # # ### ############# ##### # # ####### # ##### #
# #   # #   # #   # #   #     #   #   #   #         #   #     #   #   #   #   # #
# # # ### # # # # # # ##### # ####### # ### ### ### # ### ####### # # ### ### # #
# # # #   # #   # #   #     #       # #     # # #   # #   #     #   # #   #   # #
# # # # ### ##### # ### ############# # ##### # # ### # ##### # ##### # ### # # #
# # # #   # #     # # #     #       # #   #   # #     # #     #     # #     # # #
# ### ### # # ##### # ##### # ##### # ### ### # ####### # # ####### # ######### #
#     # # # # #   # # #   #       # # #       #       # # # #     # #     #     #
##### # # # # # ### # # # ####### # # ####### ####### # ### ### ### ##### # #####
#   #   # #   #   # # # #     #   # #       # #     # #   #   # #   #     # #   #
# ##### # ####### # # # ##### # ### ####### # # ##### ### ### # # ### ### # # # #
#       # #     # #   #   # # #   #       # #   #       # #   #   #   #   # # # #
# ####### # ### # ### ### # # ##### ####### # ### # ##### # ### ### ####### # # #
#   #     #   #   #     # #       # #       # #   # #     #   # # # #     # # # #
### # ##### # # ### ##### # ##### # # ######### ##### ####### # # # # ### # # ###
#   #     # # # #   #   # # #   #   # #         #     #     # #   # # # #   #   #
# ####### ### ### ### # # # # # ##### # ### ### # ##### ### # ##### # # ####### #
#   #   #   #       # # # # # #     # # #   #   #   #   #     #   # # #     #   #
### ### ### ### ##### # # ### ##### # ### ######### ### ####### # # # # ### # # #
#   #     #   # #   # # #   # #   # #   #         # #   #       #   # #   #   # #
# ### ### ### ### # # # ### # # # # ### ######### # # # # ########### ### ##### #
# #   # # # #     #   #   #   # # #   # #   #     # # # #             #   #   # #
# # ### # # ############# # ### ##### # # # # ##### # ################# ### ### #
#   #   #               # #     #   #     # #   #   #               #   #     # #
##### ##### ########### # ####### # ####### ### # ############# ### # ### ### # #
#           #       #   #       # #     #   #   #   #           # # # # # #   # #
# ########### ##### ########### # ##### # ### # ### # ########### # # # # # # # #
#   #   #     #   #             #     # # #   # #   #     #   #   #   #   # # # #
### ### # ##### ############# ####### # # # ### # ####### # # # # ######### # # #
#   #   # #                   #       # #   #   # #     # # # # #           # # #
# ### # # ### ######### ##### # ####### ######### # # # # # # # ########### ### #
# #   # #   # #       # #   # # #     #       #   # # # #   # #   #     #   #   #
# ### # ### # # ##### ### # # # ### # ####### # ##### # ##### ### # ### ##### ###
#     # #   # # #   # #   # # # #   #       #   #   # #     # #   # # #       # #
####### # ##### ### # # ### ### # ######### ##### # # ##### # # ### # ######### #
#       #           #     #       #      F        #   #       #                 #
#########################################f#######################################
